.P#######################################
..................#.....#...........#...#
#####.#.#.#############.###.#######.###.#
#...#.#.#...#.#.#.....#.#.#.#.#...#...#.#
#.###.###.#.#.#.###.###.#.#.#.#.#####.#.#
#...#...#.#.#.#.....#...#.....#.........#
###.#####.###.#####.#.#####.###.#.###.###
#.#...........#.#.............#.#...#.#.#
#.#####.#.#.###.#.#####.#####.#.#######.#
#.......#.#...#...#.....#.#...#.....#.#.#
#####.#.#######.#######.#.#####.###.#.#.#
#...#.#.#...#.........#.#.#.....#.......#
#.#.#.#####.#####.###.###.#########.#####
#.#.............#...#...#...#...#...#...#
#.###.###########.#########.#.#####.#.###
#.#.#.......#...#.#..X#...#...........#.#
###.#####.#####.#.#.###.#.#####.#.#####.#
#...#.......#.#...#.#.#.#...#...#...#.#.#
#.#########.#.#.#.#.#.#.#.###.###.###.#.#
#.#.............#.#.....#.......#...#.#.#
#.#.#.###.#######.#########.#########.#.#
#...#...#.#.#.......#.#...........#.....#
###########.#####.###.#####.#.#.#####.###
#.#.......#.....#.#.#.#.#...#.#.........#
#.#####.#.#.#####.#.#.#.#######.#######.#
#.......#.....#.#.#.#...#.#.#.....#.....#
#.#########.###.###.###.#.#.###.###.#.#.#
#.#.................#.......#.#.#...#.#.#
###.#####.#.###.#.###.#######.###.#####.#
#.#...#...#.#.#.#.#.#...#.#.#.#...#.....#
#.#.#.###.###.#####.#.###.#.#.#.#.#.#.#.#
#...#...#.#.......#.#.....#...#.#.#.#.#.#
###.###.#####.#####.###.#####.#.#########
#...#.#.............#.........#.#...#...#
#.#.#.###.#############.###.###.###.#.###
#.#...#.#...#.#...#...#...#.....#.#.#...#
#####.#.###.#.###.###.###.#.###.#.#.###.#
#...#.#.#.......#...#.#...#.#.#.#.......#
#.#.#.#.#######.#.#.#.###.###.#.#####.#.#
#.#.....#.........#...........#.......#.#
#######################################G#